{
  "level_1": [{
      "walls": [
         9,11,10,12,15,11,11,9,9,9,9,9,9,11,9,11,9,13,
         9,0,0,0,0,0,0,0,0,0,0,0,0,0,0,0,0,9,
         10,0,0,0,0,0,0,0,0,0,0,0,0,0,0,0,0,11,
         10,0,0,0,0,15,15,15,15,0,15,15,15,15,0,0,0,9,
         12,0,0,0,0,11,7,5,15,0,15,5,5,15,0,0,0,9,
         10,0,0,0,0,10,5,5,15,0,15,5,4,15,0,0,0,10,
         13,0,0,0,0,11,6,5,15,0,15,4,5,15,0,0,0,9,
         10,0,0,0,0,15,5,5,15,0,15,7,5,15,0,0,0,15,
         12,0,0,0,0,15,15,15,15,0,15,15,15,15,0,0,0,10,
         10,0,0,0,0,0,0,0,0,0,0,0,0,0,0,0,0,9,
         9,0,0,0,0,0,0,0,0,0,0,0,0,0,0,0,0,9,
         10,9,10,9,9,12,10,13,11,0,15,15,15,11,10,9,9,11
      ],
    "capsule_position": {"x": 6,"y":3}, 
    "player_position": {"x": 13,"y":3}, 
    "portal_position": {"x": 9,"y":12},
    "rock_position": [{"x": 0,"y":0}], 
    "mummy_position": [{"x": 0,"y":0}], 
    "locust_position": [{"x": 0,"y":0}], 
    "door_position": {"x": 0,"y":0},
    "key_position": {"x":0,"y":0} 
    }
  ],
  "level_2": [{
      "walls": [
         9,11,10,12,15,11,11,9,9,9,9,9,9,11,9,11,9,13,
         9,0,0,0,0,0,0,0,0,0,0,0,0,0,0,0,0,9,
         10,0,0,0,0,0,0,0,0,0,0,0,0,0,0,0,0,11,
         10,0,0,15,7,5,6,0,7,6,6,5,6,5,9,0,0,9,
         10,0,0,15,7,5,6,5,7,6,6,5,6,5,9,0,0,9,
         10,0,0,15,7,5,6,6,7,6,6,5,6,5,9,0,0,9,
         13,0,0,9,0,0,0,0,0,0,0,0,0,0,15,0,0,9,
         10,13,12,10,10,15,15,15,15,15,0,15,14,0,15,15,15,9,
         12,16,17,16,16,16,16,16,16,15,15,14,16,16,16,16,16,9,
         10,16,16,16,16,16,16,16,16,16,16,16,16,16,16,16,16,9,
         9,16,16,16,16,16,16,16,16,16,16,16,16,16,16,16,16,9,
         10,9,14,9,9,12,15,13,11,14,15,15,15,11,15,9,9,11
      ],
    "capsule_position": {"x": 5,"y":7}, 
    "player_position": {"x": 2,"y":3}, 
    "portal_position": {"x": 13,"y":8},
    "rock_position": [{"x": 8,"y":4}], 
    "mummy_position": [{"x": 0,"y":0}], 
    "locust_position": [{"x": 0,"y":0}], 
    "door_position": {"x": 0,"y":0},  
    "key_position": {"x":0,"y":0} 
    }
  ],
  "level_3": [{
      "walls": [
        10,10,10,10,10,10,10,10,10,10,10,10,10,10,10,10,10,10,
10,6,7,5,6,5,7,5,0,0,2,0,0,0,0,0,0,10,
10,5,10,11,11,11,11,11,11,0,2,0,10,10,10,10,0,10,
10,7,10,0,0,0,0,0,11,0,2,0,10,0,0,0,0,10,
10,5,10,0,0,0,0,0,11,0,2,0,10,0,0,10,0,10,
10,5,10,0,0,0,0,0,11,0,2,0,10,10,10,10,0,10,
10,6,0,0,0,0,0,0,11,0,2,0,0,0,0,0,0,10,
10,6,10,0,0,0,0,0,11,0,2,0,10,10,10,10,10,10,
10,7,10,0,0,0,0,0,11,0,2,0,10,0,0,0,0,10,
10,5,10,10,10,10,10,10,10,0,2,0,10,10,10,10,0,10,
10,6,5,6,4,6,5,7,4,0,2,0,0,0,0,0,0,10,
10,10,10,10,10,10,10,10,10,10,10,10,10,10,10,10,10,10
      ],
    "capsule_position": {"x": 14,"y":2}, 
    "player_position": {"x": 6,"y":6}, 
    "portal_position": {"x": 16,"y":3},
    "rock_position": [{"x": 8,"y":2}], 
    "mummy_position": [{"x": 0,"y":0}], 
    "locust_position": [{"x": 10,"y":10,"xv": 0,"yv":1}], 
    "door_position": {"x": 13,"y":3},
    "key_position": {"x":14,"y":5} 
    }
  ],
  "level_4": [{
      "walls": [
        9,9,9,9,9,9,9,9,9,9,9,9,9,9,9,9,9,9,
9,0,0,0,0,0,0,0,0,0,0,0,0,0,0,6,0,9,
9,0,0,0,0,9,0,0,0,0,0,9,0,0,0,9,0,9,
9,0,0,0,0,9,0,0,0,0,0,9,0,0,0,9,0,9,
9,0,0,0,0,9,0,0,0,0,0,9,0,0,0,9,0,9,
9,0,0,0,0,9,0,0,0,0,0,9,0,0,0,9,0,9,
9,0,0,0,0,9,0,0,6,0,0,9,0,0,0,9,0,9,
9,0,0,0,0,9,0,0,0,0,0,9,0,0,0,9,0,9,
9,0,0,0,0,9,0,0,0,0,0,9,0,0,0,9,0,9,
9,0,0,0,0,9,0,0,0,0,0,9,0,0,0,9,0,9,
9,0,0,0,0,0,0,0,0,0,0,0,0,0,0,9,0,9,
9,9,9,9,9,9,9,9,9,9,9,9,9,9,9,9,9,9
      ],
    "capsule_position": {"x": 6,"y":3}, 
    "player_position": {"x": 13,"y":3}, 
    "portal_position": {"x": 9,"y":12},
    "rock_position": [{"x": 0,"y":0}], 
    "mummy_position": [{"x": 0,"y":0}], 
    "locust_position": [{"x": 0,"y":0}], 
    "door_position": {"x": 0,"y":0},
    "key_position": {"x":0,"y":0}    
    }
  ],
  "level_5": [{
      "walls": [
        14,10,10,10,10,14,14,13,14,10,10,14,13,10,10,10,10,13,
        10,0,0,0,0,0,0,0,0,0,0,0,0,0,0,0,0,10,
        10,0,0,0,0,0,0,0,0,0,0,0,0,0,0,0,0,11,
        10,0,0,9,5,4,5,0,5,5,4,5,6,5,9,0,0,10,
        14,0,0,9,5,8,5,5,5,5,4,4,5,6,14,0,0,13,
        10,0,0,14,8,5,6,5,4,5,5,5,8,5,14,0,0,10,
        14,0,0,9,0,0,0,0,0,0,0,0,0,0,9,0,0,11,
        10,9,11,9,9,11,9,9,9,11,0,9,9,11,9,11,9,10,
        11,1,2,1,3,1,1,1,1,9,15,11,1,1,1,2,1,10,
        11,2,1,2,1,3,1,2,3,1,1,2,1,3,3,2,2,11,
        10,1,3,1,1,2,1,1,3,2,2,1,1,1,1,1,1,10,
        12,13,10,12,10,12,10,10,15,9,12,10,10,10,15,13,10,15
      ],
    "capsule_position": {"x": 6,"y":3}, 
    "player_position": {"x": 13,"y":3}, 
    "portal_position": {"x": 9,"y":12},
    "rock_position": [{"x": 0,"y":0}], 
    "mummy_position": [{"x": 0,"y":0}], 
    "locust_position": [{"x": 0,"y":0}], 
    "door_position": {"x": 0,"y":0},
    "key_position": {"x":0,"y":0}    
    }
  ],
  "level_6": [{
      "walls": [
        9,11,10,12,15,11,11,9,9,9,9,9,9,11,9,11,9,13,
        9,0,0,0,0,0,0,0,0,0,0,0,0,0,0,0,0,9,
        10,0,0,0,0,0,0,0,0,0,0,0,0,0,0,0,0,11,
        10,0,0,0,0,16,16,16,16,0,16,16,16,16,0,0,0,9,
        12,0,0,0,0,11,7,5,16,0,16,5,5,16,0,0,0,9,
        10,0,0,0,0,10,5,5,16,0,16,5,4,16,0,0,0,10,
        13,0,0,0,0,11,6,5,16,0,16,4,5,16,0,0,0,9,
        10,0,0,0,0,16,5,5,16,0,16,8,5,16,0,0,0,15,
        12,0,0,0,0,16,16,16,16,0,16,16,16,16,0,0,0,10,
        10,0,0,0,0,0,0,0,0,0,0,0,0,0,0,0,0,9,
        9,0,0,0,0,0,0,0,0,0,0,0,0,0,0,0,0,9,
        10,9,10,9,9,12,10,13,11,10,15,15,16,11,10,9,9,11
      ],
    "capsule_position": {"x": 6,"y":3}, 
    "player_position": {"x": 13,"y":3}, 
    "portal_position": {"x": 9,"y":12},
    "rock_position": [{"x": 0,"y":0}], 
    "mummy_position": [{"x": 0,"y":0}], 
    "locust_position": [{"x": 0,"y":0}], 
    "door_position": {"x": 0,"y":0},
    "key_position": {"x":0,"y":0}    
    }
  ]
}