{
  "level_1": [{
      "walls": [
        10,10,10,10,10,10,10,10,10,10,10,10,10,10,10,10,10,10,
10,0,0,0,0,0,0,0,0,0,0,0,0,0,2,0,0,10,
10,0,0,0,0,0,0,0,0,0,0,0,0,0,2,0,0,10,
10,0,0,0,0,0,0,0,0,0,0,0,0,0,2,2,2,10,
10,0,0,0,0,0,0,0,0,0,0,0,0,0,2,0,0,10,
10,2,2,2,2,0,0,0,0,0,0,2,2,2,2,0,0,10,
10,5,5,5,2,2,2,2,2,2,0,0,0,0,5,5,5,10,
10,5,0,5,0,0,0,0,0,0,0,0,0,0,5,0,5,10,
10,5,0,5,5,5,5,5,5,5,5,5,5,5,5,0,5,10,
10,5,0,5,5,5,5,5,5,5,5,5,5,5,5,0,5,10,
10,10,10,10,10,10,5,9,5,10,10,5,10,5,10,5,10,10,
10,10,10,10,10,10,10,10,10,10,10,10,10,10,10,10,10,10
      ]
    }
  ]
}