{
  "level_1": [{
      "walls": [
        9,11,10,12,15,11,11,9,9,9,9,9,9,11,9,11,9,13,
         9,0,0,0,0,0,0,0,0,0,0,0,0,0,0,0,0,9,
         10,0,0,0,0,0,0,0,0,0,0,0,0,0,0,0,0,11,
         10,0,0,0,0,15,15,15,15,0,15,15,15,15,0,0,0,9,
         12,0,0,0,0,11,7,5,15,0,15,5,5,15,0,0,0,9,
         10,0,0,0,0,10,5,5,15,0,15,5,4,15,0,0,0,10,
         13,0,0,0,0,11,6,5,15,0,15,4,5,15,0,0,0,9,
         10,0,0,0,0,15,5,5,15,0,15,7,5,15,0,0,0,15,
         12,0,0,0,0,15,15,15,15,0,15,15,15,15,0,0,0,10,
         10,0,0,0,0,0,0,0,0,0,0,0,0,0,0,0,0,9,
         9,0,0,0,0,0,0,0,0,0,0,0,0,0,0,0,0,9,
         10,9,10,9,9,12,10,13,11,0,15,15,15,11,10,9,9,11
      ]
    }
  ]
}