{
  "level_1": [{
      "walls": [
         9,11,10,12,15,11,11,9,9,9,9,9,9,11,9,11,9,13,
         9,0,0,0,0,0,0,0,0,0,0,0,0,0,0,0,0,9,
         10,0,0,0,0,0,0,0,0,0,0,0,0,0,0,0,0,11,
         10,0,0,0,0,15,15,15,15,0,15,15,15,15,0,0,0,9,
         12,0,0,0,0,11,7,5,15,0,15,5,5,15,0,0,0,9,
         10,0,0,0,0,10,5,5,15,0,15,5,4,15,0,0,0,10,
         13,0,0,0,0,11,6,5,15,0,15,4,5,15,0,0,0,9,
         10,0,0,0,0,15,5,5,15,0,15,7,5,15,0,0,0,15,
         12,0,0,0,0,15,15,15,15,0,15,15,15,15,0,0,0,10,
         10,0,0,0,0,0,0,0,0,0,0,0,0,0,0,0,0,9,
         9,0,0,0,0,0,0,0,0,0,0,0,0,0,0,0,0,9,
         10,9,10,9,9,12,10,13,11,0,15,15,15,11,10,9,9,11
      ],
    "capsule_position": [{"x": 6,"y":3}], 
    "explosive_position": [{"x": 0,"y":0}], 
    "player_position": {"x": 13,"y":4}, 
    "portal_position": {"x": 10,"y":13},
    "rock_position": [{"x": 0,"y":0}], 
    "mummy_position": [{"x": 0,"y":0}], 
    "locust_position": [{"x": 0,"y":0}], 
    "door_position": {"x": 0,"y":0},
    "key_position": {"x":0,"y":0}, 
    "sand_offset": 0 
    }
  ],
  "level_2": [{
      "walls": [
         9,11,10,12,15,11,11,9,9,9,9,9,9,11,9,11,9,13,
         9,0,0,0,0,0,0,0,0,0,0,0,0,0,0,0,0,9,
         10,0,0,0,0,0,0,0,0,0,0,0,0,0,0,0,0,11,
         10,0,0,15,7,5,6,0,7,6,6,5,6,5,9,0,0,9,
         10,0,0,15,7,5,6,5,7,6,6,5,6,5,9,0,0,9,
         10,0,0,15,7,5,6,6,7,6,6,5,6,5,9,0,0,9,
         13,0,0,9,0,0,0,0,0,0,0,0,0,0,15,0,0,9,
         10,13,12,10,10,15,15,15,15,15,0,15,14,0,15,15,15,9,
         12,16,17,16,16,16,16,16,16,15,15,14,16,16,16,16,16,9,
         10,16,16,16,16,16,16,16,16,16,16,16,16,16,16,16,16,9,
         9,16,16,16,16,16,16,16,16,16,16,16,16,16,16,16,16,9,
         10,9,14,9,9,12,15,13,11,14,15,15,15,11,15,9,9,11
      ],
    "capsule_position": [{"x": 6,"y":7}], 
    "explosive_position": [{"x": 0,"y":0}], 
    "player_position": {"x": 3,"y": 4}, 
    "portal_position": {"x": 14,"y":9},
    "rock_position": [{"x": 8,"y":4}], 
    "mummy_position": [{"x": 0,"y":0}], 
    "locust_position": [{"x": 0,"y":0}], 
    "door_position": {"x": 0,"y":0},  
    "key_position": {"x":0,"y":0}, 
    "sand_offset": 24  
    }
  ],
  "level_3": [{
      "walls": [
        10,10,10,10,10,10,10,10,10,10,10,10,10,10,10,10,10,10,
        10,6,7,5,6,5,7,5,0,0,2,0,0,0,0,0,0,10,
        10,5,10,11,11,11,11,11,11,0,2,0,10,10,10,10,0,10,
        10,7,10,0,0,0,0,0,11,0,2,0,10,0,0,0,0,10,
        10,5,10,0,0,0,0,0,11,0,2,0,10,0,0,10,0,10,
        10,5,10,0,0,0,0,0,11,0,2,0,10,10,10,10,0,10,
        10,6,0,0,0,0,0,0,11,0,2,0,0,0,0,0,0,10,
        10,6,10,0,0,0,0,0,11,0,2,0,10,10,10,10,10,10,
        10,7,10,0,0,0,0,0,11,0,2,0,10,0,0,0,0,10,
        10,5,10,10,10,10,10,10,10,0,2,0,10,10,10,10,0,10,
        10,6,5,6,4,6,5,7,4,0,2,0,0,0,0,0,0,10,
        10,10,10,10,10,10,10,10,10,10,10,10,10,10,10,10,10,10
      ],
    "capsule_position": [{"x": 15,"y":2}], 
    "explosive_position": [{"x": 0,"y":0}], 
    "player_position": {"x": 6,"y":6}, 
    "portal_position": {"x": 17,"y":4},
    "rock_position": [{"x": 8,"y":2}], 
    "mummy_position": [{"x": 0,"y":0}], 
    "locust_position": [{"x": 10,"y":10,"xv": 0,"yv":1}], 
    "door_position": {"x": 13,"y":3},
    "key_position": {"x":15,"y":6}
    }
  ],
  "level_4": [{
      "walls": [
        9,9,9,9,9,9,9,9,9,9,9,9,9,9,9,9,9,9,
        9,0,0,0,0,0,0,0,0,0,0,0,0,0,0,6,0,9,
        9,0,0,0,0,9,0,0,0,0,0,9,0,0,0,9,0,9,
        9,0,0,0,0,9,0,0,0,0,0,9,0,0,0,9,0,9,
        9,0,0,0,0,9,0,0,0,0,0,9,0,0,0,9,0,9,
        9,0,0,0,0,9,0,0,0,0,0,9,0,0,0,9,0,9,
        9,0,0,0,0,9,0,0,6,0,0,9,0,0,0,9,0,9,
        9,0,0,0,0,9,0,0,0,0,0,9,0,0,0,9,0,9,
        9,0,0,0,0,9,0,0,0,0,0,9,0,0,0,9,0,9,
        9,0,0,0,0,9,0,0,0,0,0,9,0,0,0,9,0,9,
        9,0,0,0,0,0,0,0,0,0,0,0,0,0,0,9,0,9,
        9,9,9,9,9,9,9,9,9,9,9,9,9,9,9,9,0,9
      ],
    "capsule_position": [{"x": 17,"y":3}], 
    "explosive_position": [{"x": 0,"y":0}], 
    "player_position": {"x": 3,"y":7}, 
    "portal_position": {"x": 17,"y":13},
    "rock_position": [{"x": 0,"y":0}], 
    "mummy_position": [{"x": 9,"y":8,"xv": 0,"yv":1}], 
    "locust_position": [{"x": 0,"y":0}], 
    "door_position": {"x": 17,"y":4},
    "key_position": {"x":9,"y":7}
    }
  ],
  "level_5": [{
      "walls": [
        11,11,11,11,11,11,11,11,11,11,11,11,11,11,11,11,11,11,
        11,7,7,7,7,7,7,7,7,7,7,7,7,7,7,7,7,11,
        11,0,0,0,0,0,0,0,0,0,0,0,0,0,0,0,0,11,
        11,0,0,0,0,0,0,0,0,0,0,0,0,0,0,0,0,11,
        11,2,2,0,2,2,2,10,10,10,10,10,10,10,10,10,10,11,
        11,2,2,0,2,2,2,0,0,0,0,0,0,0,0,0,0,11,
        11,2,2,0,2,2,2,0,6,6,0,0,0,0,0,0,0,11,
        11,2,2,2,2,2,2,0,6,6,0,0,6,9,0,0,0,11,
        11,2,2,2,2,2,2,0,6,6,0,9,9,9,0,0,0,11,
        11,2,2,2,2,2,2,0,6,6,0,0,0,0,0,0,0,11,
        11,0,0,0,0,0,0,0,0,0,0,11,2,2,2,2,2,11,
        11,11,11,11,11,11,11,11,11,11,0,11,11,11,11,11,11,11
      ],
    "capsule_position": [{"x": 14,"y":8},{"x": 12,"y":9}], 
    "explosive_position": [{"x": 10,"y":5},{"x": 8,"y":5},{"x": 6,"y":5}], 
    "player_position": {"x": 13,"y":5}, 
    "portal_position": {"x": 11,"y":13},
    "rock_position": [{"x": 0,"y":0}], 
    "mummy_position": [{"x": 0,"y":0}], 
    "locust_position": [{"x": 0,"y":0}], 
    "door_position": {"x": 0,"y":0},
    "key_position": {"x":0,"y":0}
    }
  ],
  "level_6": [{
      "walls": [
        11,11,11,11,11,11,11,11,11,11,11,11,11,11,11,11,11,11,
        11,0,0,0,0,0,0,10,6,6,6,6,6,0,0,0,0,11,
        11,0,2,2,2,2,2,10,6,0,6,0,0,0,0,0,0,11,
        11,0,2,2,2,2,2,10,2,2,2,2,2,0,0,0,0,11,
        11,0,2,2,2,2,2,10,0,0,0,0,0,0,0,0,0,11,
        11,0,2,2,2,2,2,10,5,0,0,0,0,0,0,0,0,11,
        11,0,2,2,2,2,2,10,2,2,0,0,0,0,0,0,0,11,
        11,0,2,2,2,2,2,10,0,2,0,0,0,0,0,0,0,11,
        11,0,2,2,2,2,2,10,2,2,0,0,0,0,0,0,0,11,
        11,0,0,0,0,0,0,1,0,0,0,0,0,0,0,0,0,11,
        11,0,0,0,0,0,0,1,5,5,5,5,5,5,5,5,5,11,
        11,11,11,11,11,11,11,9,11,11,11,11,11,11,11,0,11,11
      ],
    "capsule_position": [{"x": 10,"y":4},{"x": 12,"y": 4}], 
    "explosive_position": [{"x": 2,"y":11},{"x": 2,"y":11},
    {"x": 4,"y":11},{"x": 5,"y":12},{"x": 6,"y":11}], 
    "player_position": {"x": 7,"y":3}, 
    "portal_position": {"x": 16,"y":13},
    "rock_position": [{"x": 3,"y":2},{"x": 2,"y":12},
  {"x": 4,"y":12},{"x": 5,"y":11},{"x": 6,"y":12}], 
    "mummy_position": [{"x": 0,"y":0}], 
    "locust_position": [{"x": 0,"y":0}], 
    "door_position": {"x": 13,"y":4},
    "key_position": {"x":9,"y":9}
    }
  ],
    "level_7": [{
      "walls": [
        10,10,10,10,10,10,10,10,10,10,10,10,10,10,10,10,10,10,
        10,0,0,4,4,4,4,4,4,4,4,0,0,4,2,0,0,10,
        10,0,4,4,0,0,4,4,4,4,4,4,4,4,2,0,0,10,
        10,0,0,4,0,0,4,0,4,4,4,4,4,4,2,2,2,10,
        10,0,0,4,0,0,4,0,4,4,4,4,4,4,2,0,0,10,
        10,2,2,2,2,0,0,0,0,0,0,2,2,2,2,0,0,10,
        10,5,5,5,2,2,2,2,2,2,0,0,0,0,5,5,5,10,
        10,5,0,5,0,0,0,0,0,0,0,0,0,0,5,0,5,10,
        10,5,0,5,5,5,5,5,5,5,5,5,5,5,5,0,5,10,
        10,5,0,5,5,5,5,5,5,5,5,5,5,5,5,0,5,10,
        10,10,10,10,10,10,5,0,5,10,10,5,10,5,10,5,10,10,
        10,10,10,10,10,10,10,10,10,10,10,10,10,10,10,10,10,10
      ],
    "capsule_position": [{"x": 8,"y":7},{"x": 8,"y":6},{"x": 8,"y":5},
{"x": 3,"y":9},{"x": 3,"y":10},{"x": 3,"y":11},
{"x": 16,"y":9},{"x": 16,"y":10},{"x": 16,"y":11}  ], 
    "explosive_position": [{"x": 12,"y":2},{"x": 13,"y":2}], 
    "player_position": {"x": 7,"y":7}, 
    "portal_position": {"x": 8,"y":12},
    "rock_position": [{"x": 3,"y":2}], 
    "mummy_position": [{"x": 0,"y":0}], 
    "locust_position": [{"x": 2,"y":2}], 
    "door_position": {"x": 0,"y":0},
    "key_position": {"x":5,"y":6}
    }
  ],
    "level_8": [{
      "walls": [
        10,10,10,10,10,10,10,10,10,10,10,10,10,10,10,10,10,10,
        10,0,0,0,0,0,0,0,0,0,0,0,4,0,0,0,0,10,
        10,7,7,0,7,0,0,6,6,0,6,0,0,0,0,4,4,10,
        10,0,2,2,0,0,6,0,0,0,6,11,0,6,0,1,1,10,
        10,7,0,0,0,6,0,6,0,6,0,0,11,6,1,1,0,10,
        10,0,0,2,2,6,1,0,0,0,3,0,11,6,0,6,5,10,
        10,7,7,0,2,6,0,0,0,0,8,8,0,6,1,1,1,10,
        10,0,0,0,0,6,0,0,10,2,2,0,0,0,0,0,7,10,
        10,0,7,0,2,2,2,0,0,0,0,5,0,0,7,0,0,10,
        10,0,0,0,6,6,6,0,7,7,7,0,0,0,0,0,7,10,
        10,1,1,1,1,1,1,1,1,1,1,1,0,1,1,1,1,10,
        10,10,10,10,10,10,10,10,10,10,10,10,10,10,10,10,10,10
      ],
    "capsule_position": [{"x": 3,"y":3},{"x": 4,"y":4},{"x": 7,"y":6},{"x": 11,"y":6},
    {"x": 10,"y":7},{"x": 5,"y":9},{"x": 15,"y":7}], 
    "explosive_position": [{"x": 7,"y":3},{"x": 7,"y":4},{"x": 8,"y":3},{"x": 17,"y":3}], 
    "player_position": {"x": 3,"y":7}, 
    "portal_position": {"x": 13,"y":12},
    "rock_position": [{"x": 0,"y":0}], 
    "mummy_position": [{"x": 0,"y":0}], 
    "locust_position": [{"x": 0,"y":0}], 
    "door_position": {"x": 13,"y":11},
    "key_position": {"x":17,"y":6}
    }
  ],
    "level_9": [{
      "walls": [
        11,11,11,11,11,11,11,11,11,11,11,11,11,11,11,11,11,11,
        11,5,5,5,5,5,11,0,0,5,5,5,11,0,5,5,5,11,
        11,5,5,5,5,5,11,0,11,5,5,5,11,5,5,0,5,11,
        11,5,5,5,5,5,11,0,11,5,5,5,1,0,5,5,5,11,
        11,11,5,11,11,11,11,0,11,5,5,5,11,11,0,5,0,11,
        11,11,0,0,1,0,0,0,11,5,5,5,11,0,0,5,0,11,
        11,11,0,0,11,11,11,1,11,5,5,5,11,0,0,5,0,11,
        11,11,0,0,0,11,11,6,11,5,5,0,11,0,0,5,0,11,
        11,11,0,11,0,11,11,11,11,5,5,5,11,0,0,5,0,11,
        11,11,0,0,0,11,0,5,5,5,5,5,11,5,5,5,0,11,
        11,11,11,11,0,11,0,0,0,0,0,5,1,0,0,0,0,11,
        11,11,11,11,11,11,11,11,11,11,11,11,11,11,11,11,11,11
      ],
    "capsule_position": [{"x": 4,"y":11}], 
    "explosive_position": [{"x": 6,"y":7},{"x": 7,"y":7},{"x": 8,"y":7},{"x": 8,"y":6},
                           {"x": 14,"y":2},{"x": 12,"y":8}], 
    "player_position": {"x": 10,"y":12}, 
    "portal_position": {"x": 5,"y":12},
    "rock_position": [{"x": 9,"y":2},{"x": 13,"y":9}], 
    "mummy_position": [{"x": 0,"y":0}], 
    "locust_position": [{"x": 0,"y":0}], 
    "door_position": {"x": 3,"y":10},
    "key_position": {"x":16,"y":4}
    }
  ],
    "level_10": [{
      "walls": [
        13,13,13,13,13,13,13,13,13,13,13,13,13,13,13,13,13,13,
        13,0,0,0,0,0,0,0,0,0,0,0,0,0,0,0,0,13,
        13,0,0,0,4,0,0,0,0,0,0,0,0,0,4,0,0,13,
        13,0,0,0,0,2,2,2,2,0,11,11,11,0,0,0,0,13,
        13,0,0,0,0,0,0,0,0,0,0,0,0,0,0,0,0,13,
        13,0,0,0,0,0,0,0,0,0,0,0,0,0,0,0,0,13,
        13,0,0,0,0,0,0,0,0,0,0,0,2,2,2,2,2,13,
        13,10,10,10,0,10,0,0,0,0,0,0,2,0,0,0,0,13,
        13,5,5,5,5,5,0,0,0,0,0,0,2,0,0,0,0,13,
        13,5,5,5,5,5,0,0,0,0,0,0,2,0,0,0,0,13,
        13,5,0,0,5,5,10,10,10,0,10,0,2,0,0,0,0,13,
        13,13,13,13,13,13,13,13,13,13,13,13,13,13,13,13,13,13
      ],
    "capsule_position": [{"x":7,"y":4},{"x":3,"y":8},{"x":11,"y":11}], 
    "explosive_position": [{"x": 15,"y":7}], 
    "player_position": {"x": 10,"y":4}, 
    "portal_position": {"x": 10,"y":12},
    "rock_position": [{"x": 5,"y":2},{"x": 14,"y":2}], 
    "mummy_position": [{"x": 0,"y":0}], 
    "locust_position": [{"x": 0,"y":0}], 
    "door_position": {"x": 10,"y":11},
    "key_position": {"x":17,"y":12}
    }
  ]
}